{"map" : {
    "size":{
    "height" : 10,
    "width" : 10
     },
     "tiles": [

{"row":["w","w","w","w","w","w","w","w","w","w","w","w","w","w","w","w","w","w","w","w","w","w","w","w","w"]},
{"row":["w","w","w","w","w","w","w","f","f","f","f","f","f","w","w","w","w","w","w","w","w","w","w","w","w"]},
{"row":["w","w","w","w","w","w","w","f","f","f","f","f","f","w","w","w","w","w","w","w","w","w","w","w","w"]},
{"row":["w","w","w","w","w","w","w","f","f","f","f","f","f","w","w","w","w","w","w","w","w","w","w","w","w"]},
{"row":["w","w","w","w","w","w","w","f","f","f","f","f","f","w","w","w","w","w","w","w","w","w","w","w","w"]},
{"row":["w","w","w","w","w","w","w","f","f","f","f","f","f","w","w","w","w","w","w","w","w","w","w","w","w"]},
{"row":["w","w","w","w","w","w","w","w","w","w","f","w","w","w","f","f","f","f","f","w","w","w","w","w","w"]},
{"row":["w","w","w","w","w","w","w","w","w","w","f","w","w","w","f","f","f","f","f","w","w","w","w","w","w"]},
{"row":["w","w","w","w","w","w","w","w","w","w","f","w","w","w","f","f","f","f","f","w","w","w","w","w","w"]},
{"row":["w","w","w","w","w","w","w","w","w","w","f","f","f","f","f","f","f","f","f","w","w","w","w","w","w"]},
{"row":["w","w","w","w","w","w","w","w","w","w","w","w","w","w","f","f","f","f","f","w","w","w","w","w","w"]},
{"row":["w","w","w","w","w","w","w","w","w","w","w","w","w","w","f","f","f","f","f","w","w","w","w","w","w"]},
{"row":["w","w","w","w","w","w","w","w","w","w","w","w","w","w","w","w","f","w","w","w","w","w","w","w","w"]},
{"row":["w","w","w","w","w","w","w","w","w","w","w","w","w","w","w","w","f","w","w","w","w","w","w","w","w"]},
{"row":["w","w","w","w","w","w","w","w","w","w","w","w","w","w","w","f","f","f","f","f","w","w","w","w","w"]},
{"row":["w","w","w","w","w","w","w","w","w","w","w","w","w","w","w","f","f","f","f","f","w","w","w","w","w"]},
{"row":["w","w","w","w","w","w","w","w","w","w","w","w","w","w","w","f","f","f","f","f","w","w","w","w","w"]},
{"row":["w","w","w","w","w","w","w","w","w","w","w","w","w","w","w","f","f","f","f","p","w","w","w","w","w"]},
{"row":["w","w","w","w","w","w","w","w","w","w","w","w","w","w","w","f","f","f","f","f","w","w","w","w","w"]},
{"row":["w","w","w","w","w","w","w","w","w","w","w","w","w","w","w","w","w","w","w","w","w","w","w","w","w"]}],
"level" : 1,
"type" : "Room",
"tileInformation":[
{
"symbol" : "w" ,
"info" : {
    "name" : "Wall"
   }
},
{
"symbol" : "f" ,
"info" : {
    "name" : "Floor"
   }
},
{
"symbol" : "p" ,
"info" : {
    "name" : "Player"
   }
}
]}}